111111111
100000011
100000011
100000001
1P0000001
1CCCCCCC1
100E00001
111111111
