111111111
100000001
100000001
100E00001
1P0000001
1CCCCCCC1
100000001
111111111
